The Grand Tour
A short I7 demonstration by Marshall Lucas
Release 1 / Serial number 130228 / Inform 7 build 6G60 (I6/v6.32 lib 6/12N) SD

Stateroom
Staterooms aboard a spaceship, even one as luxurious as the Thaleia, are tight, cramped affairs, and this one is no exception. There is barely enough room for you and the furniture. The door to the hallway is locked tight for now. East is your bathroom.

You can see a leaflet and a bed here.

>get in bed
You get onto the bed.

>get off bed
You get off the bed.

Stateroom
Staterooms aboard a spaceship, even one as luxurious as the Thaleia, are tight, cramped affairs, and this one is no exception. There is barely enough room for you and the furniture. The door to the hallway is locked tight for now. East is your bathroom.

You can see a leaflet and a bed here.

>e
Bathroom
Like your stateroom in smallness, only moreso. There is a mirror on one wall.

>look mirror
You can't see any such thing.

>look in mirror
You can't see any such thing.

* * *

The Grand Tour
A short I7 demonstration by Marshall Lucas
Release 1 / Serial number 130228 / Inform 7 build 6G60 (I6/v6.32 lib 6/12N) SD

Stateroom
Staterooms aboard a spaceship, even one as luxurious as the Thaleia, are tight, cramped affairs, and this one is no exception. There is barely enough room for you and the furniture. The door to the hallway is locked tight for now. East is your bathroom.

You can see a leaflet and a bed here.

>e
Bathroom
Like your stateroom in smallness, only moreso. There is a mirror on one wall.

Opposite the mirror is the shower, which is closed.

>look in mirror
You find nothing of interest.

>examine mirror
You look tired after your long shuttle flight to the Thaleia.

>open door
You can't see any such thing.

>open shower
That's not something you can open.