*** Run-time problem P45: Attempt to change the player to a person off-stage.

The Walking Dead - Days Gone By
The Walking Dead - Days Gone By by Marshall Lucas
Release 1 / Serial number 130306 / Inform 7 build 6G60 (I6/v6.32 lib 6/12N) SD

You groggily awaken to the sight of your best friend Shane bringing you flowers.  You recall the incident that put you here, in the hospital, when you were . . . what, what is that?  You fully awaken in your empty hospital room.  A small boquet of dying flowers is on the stand next to your bed.  You try to call the nurse, but no one answers.  The only thing you know for certain at the moment is that your are alive and your name is "Rick Grimes."  Aside from that, everything is quite foggy and it is eerily quiet.

Hospital Room (on the Hospital Bed)
You can see a Hospital Room Door and a TV here.

You can go west through the Hospital Room Door (closed) from here.

>w
(first opening the Hospital Room Door)
You'll have to get off the Hospital Bed first.

Walker2 arrives.

>n
Hallway
You can go north and south from here.

Walker arrives.

>n
Hallway
On the cafeteria door are hastily painted words.

You can also see Stairwell Door here.

You can go north through the Cafeteria Door (closed), south to Hallway, and west through Stairwell Door (closed) from here.

>n
(first opening the Cafeteria Door)
As you reach for the door a decayed looking arm shoots out to try and grab you from between the double doors.

(first unlocking the Cafeteria Door)
You lack a key that fits the Cafeteria Door.

>examine door
Someone has chained the doors shut and painted the words "Do not open! Dead inside!" on the front of it.

Walker1 and Walker2 arrive.

* * *

>n
(first opening the Cafeteria Door)
As you reach for the door a decayed looking arm shoots out to try and grab you from between the double doors.

(first unlocking the Cafeteria Door)
You lack a key that fits the Cafeteria Door.

>open door
As you reach for the door a decayed looking arm shoots out to try and grab you from between the double doors.

(first unlocking the Cafeteria Door)
You lack a key that fits the Cafeteria Door.

* * *

>n
Hallway
On the cafeteria door are hastily painted words.

You can also see Stairwell Door here.

You can go north through the Cafeteria Door (closed), south to Hallway, and west through Stairwell Door (closed) from here.

>open door
(first unlocking the Cafeteria Door)
You lack a key that fits the Cafeteria Door.

>n
(first opening the Cafeteria Door)
(first unlocking the Cafeteria Door)
You lack a key that fits the Cafeteria Door.

Walker2 arrives.

* * *

>n
Hallway
On the cafeteria door are hastily painted words.

You can also see Stairwell Door here.

You can go north through the Cafeteria Door (closed), south to Hallway, and west through Stairwell Door (closed) from here.

>w
(first opening Stairwell Door)

>d
Bottom of the Stairwell
You can see a Stairwell Door here.

You can go north through the Stairwell Door (closed) and up from here.

>n
(first opening the Stairwell Door)

>l
Millersburg Pike
You can see an open Stairwell Door, a Bicycle, and the Walker here.

You can go northwest and south through the open Stairwell Door to Bottom of the Stairwell from here.

>nw
E. Pine St & Highland Ave
You can go northwest, southeast to Millersburg Pike, and southwest from here.

>nw
E. Pike St & N. Elmarch Ave
You can go north, northwest, south, and southeast to E. Pine St & Highland Ave from here.

>nw
E. Pike St & S. Miller St
You can go north, south, southeast to E. Pike St & N. Elmarch Ave, and west from here.

>w
E. Pike St & Clifton Rd
You can go south, east to E. Pike St & S. Miller St, and west from here.

>w
E. Pike St & S. Church St
You can go north, south, and east to E. Pike St & Clifton Rd from here.

>w
You can't go that way.

>n
E. Pleasant St & Church St
You can go north, south to E. Pike St & S. Church St, and east from here.

* * *

>l
Millersburg Pike
You can see an open Stairwell Door, a Bicycle, and the Walker here.

You can go northwest and south through the open Stairwell Door to Bottom of the Stairwell from here.

>ride bicycle
You mount the Bicycle.

>nw
E. Pine St & Highland Ave (on the Bicycle)
You can go northwest, southeast to Millersburg Pike, and southwest from here.

>showme Dead Bicycle Rider
Walker - walker
location: in Bottom of the Stairwell
singular-named, improper-named; unlit, inedible, portable, ordinarily enumerated; male
printed name: "Walker"
printed plural name: "walkers"
indefinite article: "the"
description: none
initial appearance: none
carrying capacity: 100
posture: standing
RoomTable: Table of NoRooms
DirectionTable: Table of NoDirections
Destination: Hallway
PathLength: 1
PathStage: 1
Drive: 0
Turn Frequency: 1
StartTurn: 1
Status: On Patrol
MovementType: Following
Route: OneWay
RouteLeg: OutwardBound
OpeningCapability: None
ReclosingCapability: Leave
Freshness: Immobile

* * *

>l
Millersburg Pike
You can see an open Stairwell Door and a Bicycle here.

You can go northwest and south through the open Stairwell Door to Bottom of the Stairwell from here.

* * *

>l
Bottom of the Stairwell
You can see an open Stairwell Door, a Walker, and the Walker here.

You can go north through the open Stairwell Door to Millersburg Pike and up from here.

* * *

>l
Millersburg Pike
You can see an open Stairwell Door, a Bicycle, and the Walker here.

You can go northwest and south through the open Stairwell Door to Bottom of the Stairwell from here.

>examine walker
You can't see any such thing.

>l
Millersburg Pike
You can see an open Stairwell Door, a Bicycle, and the Walker here.

You can go northwest and south through the open Stairwell Door to Bottom of the Stairwell from here.

* * *

>w
(first opening the Hospital Room Door)
You'll have to get off the Hospital Bed first.

Walker2 arrives.

>stand
You get off the Hospital Bed.

Hospital Room
You can see a Walker2, a Hospital Room Door, and a Hospital Bed here.

You can go west through the Hospital Room Door from here.

>w
Hallway
You can see a Hospital Room Door and a Walker1 here.

You can go north and east through the Hospital Room Door to the Hospital Room from here.

It smells like rotting flesh in here
Walker2 arrives.

>n
Hallway
You can go north and south to Hallway from here.

>n
Hallway
On the cafeteria door are hastily painted words.

You can also see Stairwell Door here.

You can go north through the Cafeteria Door (closed), south to Hallway, and west through Stairwell Door (closed) from here.

>s
Hallway
You can go north to Hallway and south to Hallway from here.

Walker2 arrives.

>s
Hallway
You can see a Hospital Room Door and a Walker1 here.

You can go north to Hallway and east through the Hospital Room Door to the Hospital Room from here.

Walker2 arrives.

* * *

>get up
You get off the Hospital Bed.

Hospital Room
You can see a Hospital Room Door and a Hospital Bed here.

You can go west through the Hospital Room Door (closed) from here.

>w
(first opening the Hospital Room Door)

>n
Hallway
You can go north and south from here.

Walker and Walker arrive.

>s
Hallway
You can see a Hospital Room Door here.

You can go north to Hallway and east through the Hospital Room Door to the Hospital Room from here.

* * *

>smell
You smell nothing unexpected.

>stand
You get off the Hospital Bed.

Hospital Room
You can see a Hospital Room Door and a Hospital Bed here.

You can go west through the Hospital Room Door (closed) from here.

* * *

>smell
You smell nothing unexpected.

Walker arrives.

>smell walker
You can't see any such thing.

>smell walker1
You can't see any such thing.

>l
Hallway
You can see a Walker and a Hospital Room Door here.

You can go north and east through the Hospital Room Door to the Hospital Room from here.

>smell the walker
You can't see any such thing.

>smell walker2
smells like rotting flesh.

Walker arrives.

>ask walker1 to smell walker2
I didn't understand that sentence.

>tell walker1 to smell walker2
I didn't understand that sentence.

* * *

>smell room
You smell nothing unexpected.

>open door
Walker arrives.

>smell room
It smells like rotting flesh in here

* * *

>stand
You get off the Hospital Bed.

Hospital Room
You can see a Hospital Room Door and a Hospital Bed here.

You can go west through the Hospital Room Door (closed) from here.

* * *

>wait
Time passes.

>wait
Time passes.

* * *

>n
Hallway
You can go north and south from here.

>n
Hallway
On the cafeteria door are hastily painted words.

You can also see Stairwell Door here.

You can go north through the Cafeteria Door (closed), south to Hallway, and west through Stairwell Door (closed) from here.

* * *

>s
Hallway
You can go north to Hallway and south from here.

Walker2 arrives.

>l walker2
It is ashen and pale, with a significant hunch and dark yellow-brown eyes.
 It looks at you as if you were it's next meal!

* * *

>stand
You get off the Hospital Bed.

Hospital Room
You can see a Hospital Room Door and a Hospital Bed here.

You can go west through the Hospital Room Door (closed) from here.

>w
(first opening the Hospital Room Door)
Hallway
You can see a Hospital Room Door and a Walker1 here.

You can go north and east through the Hospital Room Door to the Hospital Room from here.

It smells like rotten flesh in here.

Walker2 arrives.

>n
Hallway
You can go north and south to Hallway from here.

It smells like rotten flesh in here.

Walker2 arrives.

>n
Hallway
On the cafeteria door are hastily painted words.

You can also see Stairwell Door here.

You can go north through the Cafeteria Door (closed), south to Hallway, and west through Stairwell Door (closed) from here.

It smells like rotten flesh in here.

Walker2 arrives.

>n
(first opening the Cafeteria Door)
As you reach for the door a decayed looking arm shoots out to try and grab you from between the double doors.  You stumble backwards, startled, just in time.  "What is going on here?" you wonder.

(first unlocking the Cafeteria Door)
You lack a key that fits the Cafeteria Door.

>s
Hallway
You can go north to Hallway and south to Hallway from here.

Walker2 arrives.

>s
Hallway
You can see a Hospital Room Door and a Walker1 here.

You can go north to Hallway and east through the Hospital Room Door to the Hospital Room from here.

>s
You can't go that way.

>e
Hospital Room
You can see a Hospital Room Door and a Hospital Bed here.

You can go west through the Hospital Room Door to Hallway from here.

>w
Hallway
You can see a Hospital Room Door and a Walker1 here.

You can go north to Hallway and east through the Hospital Room Door to the Hospital Room from here.

Walker2 arrives.

* * *

>n
Hallway
On the cafeteria door are hastily painted words.

You can also see Stairwell Door here.

You can go north through the Cafeteria Door (closed), south to Hallway, and west through Stairwell Door (closed) from here.

It smells like rotten flesh in here.

Walker2 arrives.

>l
Hallway
On the cafeteria door are hastily painted words.

You can also see Stairwell Door here.

You can go north through the Cafeteria Door (closed), south to Hallway, and west through Stairwell Door (closed) from here.

>showme walker1
Walker1 - lurker
location: in Hallway
singular-named, improper-named; unlit, inedible, portable, ordinarily enumerated; male
printed name: "Walker1"
printed plural name: "lurkers"
indefinite article: none
description: "Walker1 (walker)"
initial appearance: none
odor: "rotting flesh."
carrying capacity: 100
posture: standing
RoomTable: Table of NoRooms
DirectionTable: Table of NoDirections
Destination: Hospital Room
PathLength: 1
PathStage: 1
Drive: 20
Turn Frequency: 1
StartTurn: 4
Status: On Patrol
MovementType: Following
Route: OneWay
RouteLeg: OutwardBound
OpeningCapability: None
ReclosingCapability: Leave
Freshness: Rotted

* * *

>n
Hallway
On the cafeteria door are hastily painted words.

You can also see Stairwell Door here.

You can go north through the Cafeteria Door (closed), south to Hallway, and west through Stairwell Door (closed) from here.

It smells like rotten flesh in here.

Walker2 arrives.

>s
Hallway
You can see a Walker1 here.

You can go north to Hallway and south to Hallway from here.

It smells like rotten flesh in here.

>s
Hallway
You can see a Hospital Room Door here.

You can go north to Hallway and east through the Hospital Room Door to the Hospital Room from here.

It smells like rotten flesh in here.

Walker1 arrives.

>e
Hospital Room
You can see a Hospital Room Door and a Hospital Bed here.

You can go west through the Hospital Room Door to Hallway from here.

It smells like rotten flesh in here.

>w
Hallway
You can see a Hospital Room Door and a Walker1 here.

You can go north to Hallway and east through the Hospital Room Door to the Hospital Room from here.

It smells like rotten flesh in here.

* * *

>n
Hallway
On the cafeteria door are hastily painted words.

You can also see Stairwell Door here.

You can go north through the Cafeteria Door (closed), south to Hallway, and west through Stairwell Door (closed) from here.

It smells like rotten flesh in here.

Walker2 arrives.

>open door
Which do you mean, Stairwell Door or the Cafeteria Door?

>open cafeteria door
As you reach for the door a decayed looking arm shoots out to try and grab you from between the double doors.  You stumble backwards, startled, just in time.  "What is going on here?" you wonder.

(first unlocking the Cafeteria Door)
You lack a key that fits the Cafeteria Door.

>w
(first opening Stairwell Door)
Top of the Stairwell
You can see Stairwell Door here.

You can go east through Stairwell Door to Hallway and down from here.

It smells like rotten flesh in here.

Walker2 arrives.

>w
You can't go that way.

>d
Bottom of the Stairwell
You can see a Stairwell Door and the Dead Bicycle Rider here.

You can go north through the Stairwell Door and up to the Top of the Stairwell from here.

It smells like rotten flesh in here.

>l
Bottom of the Stairwell
You can see a Stairwell Door and the Dead Bicycle Rider here.

You can go north through the Stairwell Door and up to the Top of the Stairwell from here.

>n
Millersburg Pike
You can see a Stairwell Door and a Bicycle here.

You can go northwest and south through the Stairwell Door to Bottom of the Stairwell from here.

It smells like rotten flesh in here.

>l
Millersburg Pike
You can see a Stairwell Door and a Bicycle here.

You can go northwest and south through the Stairwell Door to Bottom of the Stairwell from here.

>ride bicycle
You mount the Bicycle.

Walker1 arrives.

>nw
E. Pine St & Highland Ave (on the Bicycle)
You can go northwest, southeast to Millersburg Pike, and southwest from here.

It smells like rotten flesh in here.

>nw
E. Pike St & N. Elmarch Ave (on the Bicycle)
You can go north, northwest, south, and southeast to E. Pine St & Highland Ave from here.

It smells like rotten flesh in here.

>showme figure
There seems to be no such object anywhere in the model world.

>showme figure of rickinhospitalbed
There seems to be no such object anywhere in the model world.

>showme rickinhospitalbed
There seems to be no such object anywhere in the model world.

* * *

>n
Hallway
You can go north and south to Hallway from here.

It smells like rotten flesh in here.

Walker2 arrives.

>s
Hallway
You can see a Hospital Room Door and a Walker1 here.

You can go north to Hallway and east through the Hospital Room Door to the Hospital Room from here.

* * *

>w
(first opening the Hospital Room Door)
Hallway
You can see a Hospital Room Door and a Walker1 here.

You can go north and east through the Hospital Room Door to the Hospital Room from here.

It smells like rotten flesh in here.

Walker2 arrives.

>showme walker1
Walker1 - lurker
location: in Hallway
singular-named, improper-named; unlit, inedible, portable, ordinarily enumerated; male
printed name: "Walker1"
printed plural name: "lurkers"
indefinite article: none
description: "Walker1 (walker)"
initial appearance: none
odor: "rotting flesh."
carrying capacity: 100
posture: standing
RoomTable: Table of NoRooms
DirectionTable: Table of NoDirections
Destination: Hospital Room
PathLength: 1
PathStage: 1
Drive: 60
Turn Frequency: 1
StartTurn: 1
Status: On Patrol
MovementType: Following
Route: OneWay
RouteLeg: OutwardBound
OpeningCapability: None
ReclosingCapability: Leave
Freshness: Rotted

>showme walker2
Walker2 - roamer
location: in Hallway
singular-named, improper-named; unlit, inedible, portable, ordinarily enumerated; male
printed name: "Walker2"
printed plural name: "roamers"
indefinite article: none
description: "Walker2 (walker)"
initial appearance: none
odor: "rotting flesh."
carrying capacity: 100
posture: standing
RoomTable: Table of NoRooms
DirectionTable: Table of NoDirections
Destination: Hospital Room
PathLength: 1
PathStage: 1
Drive: 60
Turn Frequency: 1
StartTurn: 1
Status: On Patrol
MovementType: Following
Route: OneWay
RouteLeg: OutwardBound
OpeningCapability: None
ReclosingCapability: Leave
Freshness: DayOld